". . . . . . . . . . . . . . . . . . . . . . . . . . . . . . . . . . . . . . . . . . . . . . . . . . . . . . . . . . . . . . . . . . . . . . . . . . . . . . . . . . . . . . . . . . . . . . . . . . . . . . . . . . . . . . . . . . . . . . . . . . . . . . . . . . . . .",
". # # . # # . # # . # # . # # . # # . # # . # # . # # . # # . # # . # # . # # . # # . # # . # # . # # . # # . # # . # # . # # . # # . # # . # # . # # . # # . # # . # # . # # . # # . # # . # # . # # . # # . # # . # # . # # . # # . # # . # # . # # . # # . # # . # # .",
". # # . # # . # # . # # . # # . # # . # # . # # . # # . # # . # # . # # . # # . # # . # # . # # . # # . # # . # # . # # . # # . # # . # # . # # . # # . # # . # # . # # . # # . # # . # # . # # . # # . # # . # # . # # . # # . # # . # # . # # . # # . # # . # # . # # .",
". . . . . . . . . . . . . . . . . . . . . . . . . . . . . . . . . . . . . . . . . . . . . . . . . . . . . . . . . . . . . . . . . . . . . . . . . . . . . . . . . . . . . . . . . . . . . . . . . . . . . . . . . . . . . . . . . . . . . . . . . . . . . . . . . . . . .",
". # # . # # . # # . # # . # # . # # . # # . # # . # # . # # . # # . # # . # # . # # . # # . # # . # # . # # . # # . # # . # # . # # . # # . # # . # # . # # . # # . # # . # # . # # . # # . # # . # # . # # . # # . # # . # # . # # . # # . # # . # # . # # . # # . # # .",
". # # . # # . # # . # # . # # . # # . # # . # # . # # . # # . # # . # # . # # . # # . # # . # # . # # . # # . # # . # # . # # . # # . # # . # # . # # . # # . # # . # # . # # . # # . # # . # # . # # . # # . # # . # # . # # . # # . # # . # # . # # . # # . # # . # # .",
". . . . . . . . . . . . . . . . . . . . . . . . . . . . . . . . . . . . . . . . . . . . . . . . . . . . . . . . . . . . . . . . . . . . . . . . . . . . . . . . . . . . . . . . . . . . . . . . . . . . . . . . . . . . . . . . . . . . . . . . . . . . . . . . . . . . .",
". # # . # # . # # . # # . # # . # # . # # . # # . # # . # # . # # . # # . # # . # # . # # . # # . # # . # # . # # . # # . # # . # # . # # . # # . # # . # # . # # . # # . # # . # # . # # . # # . # # . # # . # # . # # . # # . # # . # # . # # . # # . # # . # # . # # .",
". # # . # # . # # . # # . # # . # # . # # . # # . # # . # # . # # . # # . # # . # # . # # . # # . # # . # # . # # . # # . # # . # # . # # . # # . # # . # # . # # . # # . # # . # # . # # . # # . # # . # # . # # . # # . # # . # # . # # . # # . # # . # # . # # . # # .",
". . . . . . . . . . . . . . . . . . . . . . . . . . . . . . . . . . . . . . . . . . . . . . . . . . . . . . . . . . . . . . . . . . . . . . . . . . . . . . . . . . . . . . . . . . . . . . . . . . . . . . . . . . . . . . . . . . . . . . . . . . . . . . . . . . . . .",
". # # . # # . # # . # # . # # . # # . # # . # # . # # . # # . # # . # # . # # . # # . # # . # # . # # . # # . # # . # # . # # . # # . # # . # # . # # . # # . # # . # # . # # . # # . # # . # # . # # . # # . # # . # # . # # . # # . # # . # # . # # . # # . # # . # # .",
". # # . # # . # # . # # . # # . # # . # # . # # . # # . # # . # # . # # . # # . # # . # # . # # . # # . # # . # # . # # . # # . # # . # # . # # . # # . # # . # # . # # . # # . # # . # # . # # . # # . # # . # # . # # . # # . # # . # # . # # . # # . # # . # # . # # .",
". . . . . . . . . . . . . . . . . . . . . . . . . . . . . . . . . . . . . . . . . . . . . . . . . . . . . . . . . . . . . . . . . . . . . . . . . . . . . . . . . . . . . . . . . . . . . . . . . . . . . . . . . . . . . . . . . . . . . . . . . . . . . . . . . . . . .",
". # # . # # . # # . # # . # # . # # . # # . # # . # # . # # . # # . # # . # # . # # . # # . # # . # # . # # . # # . # # . # # . # # . # # . # # . # # . # # . # # . # # . # # . # # . # # . # # . # # . # # . # # . # # . # # . # # . # # . # # . # # . # # . # # . # # .",
". # # . # # . # # . # # . # # . # # . # # . # # . # # . # # . # # . # # . # # . # # . # # . # # . # # . # # . # # . # # . # # . # # . # # . # # . # # . # # . # # . # # . # # . # # . # # . # # . # # . # # . # # . # # . # # . # # . # # . # # . # # . # # . # # . # # .",
". . . . . . . . . . . . . . . . . . . . . . . . . . . . . . . . . . . . . . . . . . . . . . . . . . . . . . . . . . . . . . . . . . . . . . . . . . . . . . . . . . . . . . . . . . . . . . . . . . . . . . . . . . . . . . . . . . . . . . . . . . . . . . . . . . . . .",
". # # . # # . # # . # # . # # . # # . # # . # # . # # . # # . # # . # # . # # . # # . # # . # # . # # . # # . # # . # # . # # . # # . # # . # # . # # . # # . # # . # # . # # . # # . # # . # # . # # . # # . # # . # # . # # . # # . # # . # # . # # . # # . # # . # # .",
". # # . # # . # # . # # . # # . # # . # # . # # . # # . # # . # # . # # . # # . # # . # # . # # . # # . # # . # # . # # . # # . # # . # # . # # . # # . # # . # # . # # . # # . # # . # # . # # . # # . # # . # # . # # . # # . # # . # # . # # . # # . # # . # # . # # .",
". . . . . . . . . . . . . . . . . . . . . . . . . . . . . . . . . . . . . . . . . . . . . . . . . . . . . . . . . . . . . . . . . . . . . . . . . . . . . . . . . . . . . . . . . . . . . . . . . . . . . . . . . . . . . . . . . . . . . . . . . . . . . . . . . . . . .",
". # # . # # . # # . # # . # # . # # . # # . # # . # # . # # . # # . # # . # # . # # . # # . # # . # # . # # . # # . # # . # # . # # . # # . # # . # # . # # . # # . # # . # # . # # . # # . # # . # # . # # . # # . # # . # # . # # . # # . # # . # # . # # . # # . # # .",
". # # . # # . # # . # # . # # . # # . # # . # # . # # . # # . # # . # # . # # . # # . # # . # # . # # . # # . # # . # # . # # . # # . # # . # # . # # . # # . # # . # # . # # . # # . # # . # # . # # . # # . # # . # # . # # . # # . # # . # # . # # . # # . # # . # # .",
". . . . . . . . . . . . . . . . . . . . . . . . . . . . . . . . . . . . . . . . . . . . . . . . . . . . . . . . . . . . . . . . . . . . . . . . . . . . . . . . . . . . . . . . . . . . . . . . . . . . . . . . . . . . . . . . . . . . . . . . . . . . . . . . . . . . .",
". # # . # # . # # . # # . # # . # # . # # . # # . # # . # # . # # . # # . # # . # # . # # . # # . # # . # # . # # . # # . # # . # # . # # . # # . # # . # # . # # . # # . # # . # # . # # . # # . # # . # # . # # . # # . # # . # # . # # . # # . # # . # # . # # . # # .",
". # # . # # . # # . # # . # # . # # . # # . # # . # # . # # . # # . # # . # # . # # . # # . # # . # # . # # . # # . # # . # # . # # . # # . # # . # # . # # . # # . # # . # # . # # . # # . # # . # # . # # . # # . # # . # # . # # . # # . # # . # # . # # . # # . # # .",
". . . . . . . . . . . . . . . . . . . . . . . . . . . . . . . . . . . . . . . . . . . . . . . . . . . . . . . . . . . . . . . . . . . . . . . . . . . . . . . . . . . . . . . . . . . . . . . . . . . . . . . . . . . . . . . . . . . . . . . . . . . . . . . . . . . . .",
". # # . # # . # # . # # . # # . # # . # # . # # . # # . # # . # # . # # . # # . # # . # # . # # . # # . # # . # # . # # . # # . # # . # # . # # . # # . # # . # # . # # . # # . # # . # # . # # . # # . # # . # # . # # . # # . # # . # # . # # . # # . # # . # # . # # .",
". # # . # # . # # . # # . # # . # # . # # . # # . # # . # # . # # . # # . # # . # # . # # . # # . # # . # # . # # . # # . # # . # # . # # . # # . # # . # # . # # . # # . # # . # # . # # . # # . # # . # # . # # . # # . # # . # # . # # . # # . # # . # # . # # . # # .",
". . . . . . . . . . . . . . . . . . . . . . . . . . . . . . . . . . . . . . . . . . . . . . . . . . . . . . . . . . . . . . . . . . . . . . . . . . . . . . . . . . . . . . . . . . . . . . . . . . . . . . . . . . . . . . . . . . . . . . . . . . . . . . . . . . . . .",
". # # . # # . # # . # # . # # . # # . # # . # # . # # . # # . # # . # # . # # . # # . # # . # # . # # . # # . # # . # # . # # . # # . # # . # # . # # . # # . # # . # # . # # . # # . # # . # # . # # . # # . # # . # # . # # . # # . # # . # # . # # . # # . # # . # # .",
". # # . # # . # # . # # . # # . # # . # # . # # . # # . # # . # # . # # . # # . # # . # # . # # . # # . # # . # # . # # . # # . # # . # # . # # . # # . # # . # # . # # . # # . # # . # # . # # . # # . # # . # # . # # . # # . # # . # # . # # . # # . # # . # # . # # .",
". . . . . . . . . . . . . . . . . . . . . . . . . . . . . . . . . . . . . . . . . . . . . . . . . . . . . . . . . . . . . . . . . . . . . . . . . . . . . . . . . . . . . . . . . . . . . . . . . . . . . . . . . . . . . . . . . . . . . . . . . . . . . . . . . . . . .",
". # # . # # . # # . # # . # # . # # . # # . # # . # # . # # . # # . # # . # # . # # . # # . # # . # # . # # . # # . # # . # # . # # . # # . # # . # # . # # . # # . # # . # # . # # . # # . # # . # # . # # . # # . # # . # # . # # . # # . # # . # # . # # . # # . # # .",
". # # . # # . # # . # # . # # . # # . # # . # # . # # . # # . # # . # # . # # . # # . # # . # # . # # . # # . # # . # # . # # . # # . # # . # # . # # . # # . # # . # # . # # . # # . # # . # # . # # . # # . # # . # # . # # . # # . # # . # # . # # . # # . # # . # # .",
". . . . . . . . . . . . . . . . . . . . . . . . . . . . . . . . . . . . . . . . . . . . . . . . . . # . . . . . . . . . . . . . . . . . . . . . . . . . . . . . . . . . . . . . . . . . . . . . . . . . . . . . . . . . . . . . . . . . . . . . . . . . . . . . . . . . .",
". # # . # # . # # . # # . # # . # # . # # . # # . # # . # # . # # . # # . # # . # # . # # . # # . # # . # # . # # . # # . # # . # # . # # . # # . # # . # # . # # . # # . # # . # # . # # . # # . # # . # # . # # . # # . # # . # # . # # . # # . # # . # # . # # . # # .",
". # # . # # . # # . # # . # # . # # . # # . # # . # # . # # . # # . # # . # # . # # . # # . # # . # # . # # . # # . # # . # # . # # . # # . # # . # # . # # . # # . # # . # # . # # . # # . # # . # # . # # . # # . # # . # # . # # . # # . # # . # # . # # . # # . # # .",
". . . . . . . . . . . . . . . . . . . . . . . . . . . . . . . . . . . . . . . . . . . . . . . . . . . . . . . . . . . . . . . . . . . . . . . . . . . . . . . . . . . . . . . . . . . . . . . . . . . . . . . . . . . . . . . . . . . . . . . . . . . . . . . . . . . . .",
". # # . # # . # # . # # . # # . # # . # # . # # . # # . # # . # # . # # . # # . # # . # # . # # . # # . # # . # # . # # . # # . # # . # # . # # . # # . # # . # # . # # . # # . # # . # # . # # . # # . # # . # # . # # . # # . # # . # # . # # . # # . # # . # # . # # .",
". # # . # # . # # . # # . # # . # # . # # . # # . # # . # # . # # . # # . # # . # # . # # . # # . # # . # # . # # . # # . # # . # # . # # . # # . # # . # # . # # . # # . # # . # # . # # . # # . # # . # # . # # . # # . # # . # # . # # . # # . # # . # # . # # . # # .",
". . . . . . . . . . . . . . . . . . . . . . . . . . . . . . . . . . . . . . . . . . . . . . . . . . . . . . . . . . . . . . . . . . . . . . . . . . . . . . . . . . . . . . . . . . . . . . . . . . . . . . . . . . . . . . . . . . . . . . . . . . . . . . . . . . . . .",
". # # . # # . # # . # # . # # . # # . # # . # # . # # . # # . # # . # # . # # . # # . # # . # # . # # . # # . # # . # # . # # . # # . # # . # # . # # . # # . # # . # # . # # . # # . # # . # # . # # . # # . # # . # # . # # . # # . # # . # # . # # . # # . # # . # # .",
". # # . # # . # # . # # . # # . # # . # # . # # . # # . # # . # # . # # . # # . # # . # # . # # . # # . # # . # # . # # . # # . # # . # # . # # . # # . # # . # # . # # . # # . # # . # # . # # . # # . # # . # # . # # . # # . # # . # # . # # . # # . # # . # # . # # .",
". . . . . . . . . . . . . . . . . . . . . . . . . . . . . . . . . . . . . . . . . . . . . . . . . . . . . . . . . . . . . . . . . . . . . . . . . . . . . . . . . . . . . . . . . . . . . . . . . . . . . . . . . . . . . . . . . . . . . . . . . . . . . . . . . . . . .",
". # # . # # . # # . # # . # # . # # . # # . # # . # # . # # . # # . # # . # # . # # . # # . # # . # # . # # . # # . # # . # # . # # . # # . # # . # # . # # . # # . # # . # # . # # . # # . # # . # # . # # . # # . # # . # # . # # . # # . # # . # # . # # . # # . # # .",
". # # . # # . # # . # # . # # . # # . # # . # # . # # . # # . # # . # # . # # . # # . # # . # # . # # . # # . # # . # # . # # . # # . # # . # # . # # . # # . # # . # # . # # . # # . # # . # # . # # . # # . # # . # # . # # . # # . # # . # # . # # . # # . # # . # # .",
". . . . . . . . . . . . . . . . . . . . . . . . . . . . . . . . . . . . . . . . . . . . . . . . . . . . . . . . . . . . . . . . . . . . . . . . . . . . . . . . . . . . . . . . . . . . . . . . . . . . . . . . . . . . . . . . . . . . . . . . . . . . . . . . . . . . .",
". # # . # # . # # . # # . # # . # # . # # . # # . # # . # # . # # . # # . # # . # # . # # . # # . # # . # # . # # . # # . # # . # # . # # . # # . # # . # # . # # . # # . # # . # # . # # . # # . # # . # # . # # . # # . # # . # # . # # . # # . # # . # # . # # . # # .",
". # # . # # . # # . # # . # # . # # . # # . # # . # # . # # . # # . # # . # # . # # . # # . # # . # # . # # . # # . # # . # # . # # . # # . # # . # # . # # . # # . # # . # # . # # . # # . # # . # # . # # . # # . # # . # # . # # . # # . # # . # # . # # . # # . # # .",
". . . . . . . . . . . . . . . . . . . . . . . . . . . . . . . . . . . . . . . . . . . . . . . . . . . . . . . . . . . . . . . . . . . . . . . . . . . . . . . . . . . . . . . . . . . . . . . . . . . . . . . . . . . . . . . . . . . . . . . . . . . . . . . . . . . . .",
". # # . # # . # # . # # . # # . # # . # # . # # . # # . # # . # # . # # . # # . # # . # # . # # . # # . # # . # # . # # . # # . # # . # # . # # . # # . # # . # # . # # . # # . # # . # # . # # . # # . # # . # # . # # . # # . # # . # # . # # . # # . # # . # # . # # .",
". # # . # # . # # . # # . # # . # # . # # . # # . # # . # # . # # . # # . # # . # # . # # . # # . # # . # # . # # . # # . # # . # # . # # . # # . # # . # # . # # . # # . # # . # # . # # . # # . # # . # # . # # . # # . # # . # # . # # . # # . # # . # # . # # . # # .",
". . . . . . . . . . . . . . . . . . . . . . . . . . . . . . . . . . . . . . . . . . . . . . . . . . . . . . . . . . . . . . . . . . . . . . . . . . . . . . . . . . . . . . . . . . . . . . . . . . . . . . . . . . . . . . . . . . . . . . . . . . . . . . . . . . . . .",
". # # . # # . # # . # # . # # . # # . # # . # # . # # . # # . # # . # # . # # . # # . # # . # # . # # . # # . # # . # # . # # . # # . # # . # # . # # . # # . # # . # # . # # . # # . # # . # # . # # . # # . # # . # # . # # . # # . # # . # # . # # . # # . # # . # # .",
". # # . # # . # # . # # . # # . # # . # # . # # . # # . # # . # # . # # . # # . # # . # # . # # . # # . # # . # # . # # . # # . # # . # # . # # . # # . # # . # # . # # . # # . # # . # # . # # . # # . # # . # # . # # . # # . # # . # # . # # . # # . # # . # # . # # .",
". . . . . . . . . . . . . . . . . . . . . . . . . . . . . . . . . . . . . . . . . . . . . . . . . . . . . . . . . . . . . . . . . . . . . . . . . . . . . . . . . . . . . . . . . . . . . . . . . . . . . . . . . . . . . . . . . . . . . . . . . . . . . . . . . . . . .",
". # # . # # . # # . # # . # # . # # . # # . # # . # # . # # . # # . # # . # # . # # . # # . # # . # # . # # . # # . # # . # # . # # . # # . # # . # # . # # . # # . # # . # # . # # . # # . # # . # # . # # . # # . # # . # # . # # . # # . # # . # # . # # . # # . # # .",
". # # . # # . # # . # # . # # . # # . # # . # # . # # . # # . # # . # # . # # . # # . # # . # # . # # . # # . # # . # # . # # . # # . # # . # # . # # . # # . # # . # # . # # . # # . # # . # # . # # . # # . # # . # # . # # . # # . # # . # # . # # . # # . # # . # # .",
". . . . . . . . . . . . . . . . . . . . . . . . . . . . . . . . . . . . . . . . . . . . . . . . . . . . . . . . . . . . . . . . . . . . . . . . . . . . . . . . . . . . . . . . . . . . . . . . . . . . . . . . . . . . . . . . . . . . . . . . . . . . . . . . . . . . .",
". # # . # # . # # . # # . # # . # # . # # . # # . # # . # # . # # . # # . # # . # # . # # . # # . # # . # # . # # . # # . # # . # # . # # . # # . # # . # # . # # . # # . # # . # # . # # . # # . # # . # # . # # . # # . # # . # # . # # . # # . # # . # # . # # . # # .",
". # # . # # . # # . # # . # # . # # . # # . # # . # # . # # . # # . # # . # # . # # . # # . # # . # # . # # . # # . # # . # # . # # . # # . # # . # # . # # . # # . # # . # # . # # . # # . # # . # # . # # . # # . # # . # # . # # . # # . # # . # # . # # . # # . # # .",
". . . . . . . . . . . . . . . . . . . . . . . . . . . . . . . . . . . . . . . . . . . . . . . . . . . . . . . . . . . . . . . . . . . . . . . . . . . . . . . . . . . . . . . . . . . . . . . . . . . . . . . . . . . . . . . . . . . . . . . . . . . . . . . . . . . . .",
". # # . # # . # # . # # . # # . # # . # # . # # . # # . # # . # # . # # . # # . # # . # # . # # . # # . # # . # # . # # . # # . # # . # # . # # . # # . # # . # # . # # . # # . # # . # # . # # . # # . # # . # # . # # . # # . # # . # # . # # . # # . # # . # # . # # .",
". # # . # # . # # . # # . # # . # # . # # . # # . # # . # # . # # . # # . # # . # # . # # . # # . # # . # # . # # . # # . # # . # # . # # . # # . # # . # # . # # . # # . # # . # # . # # . # # . # # . # # . # # . # # . # # . # # . # # . # # . # # . # # . # # . # # .",
". . . . . . . . . . . . . . . . . . . . . . . . . . . . . . . . . . . . . . . . . . . . . . . . . . . . . . . . . . . . . . . . . . . . . . . . . . . . . . . . . . . . . . . . . . . . . . . . . . . . . . . . . . . . . . . . . . . . . . . . . . . . . . . . . . . . .",
". # # . # # . # # . # # . # # . # # . # # . # # . # # . # # . # # . # # . # # . # # . # # . # # . # # . # # . # # . # # . # # . # # . # # . # # . # # . # # . # # . # # . # # . # # . # # . # # . # # . # # . # # . # # . # # . # # . # # . # # . # # . # # . # # . # # .",
". # # . # # . # # . # # . # # . # # . # # . # # . # # . # # . # # . # # . # # . # # . # # . # # . # # . # # . # # . # # . # # . # # . # # . # # . # # . # # . # # . # # . # # . # # . # # . # # . # # . # # . # # . # # . # # . # # . # # . # # . # # . # # . # # . # # .",
". . . . . . . . . . . . . . . . . . . . . . . . . . . . . . . . . . . . . . . . . . . . . . . . . . . . . . . . . . . . . . . . . . . . . . . . . . . . . . . . . . . . . . . . . . . . . . . . . . . . . . . . . . . . . . . . . . . . . . . . . . . . . . . . . . . . .",
". # # . # # . # # . # # . # # . # # . # # . # # . # # . # # . # # . # # . # # . # # . # # . # # . # # . # # . # # . # # . # # . # # . # # . # # . # # . # # . # # . # # . # # . # # . # # . # # . # # . # # . # # . # # . # # . # # . # # . # # . # # . # # . # # . # # .",
". # # . # # . # # . # # . # # . # # . # # . # # . # # . # # . # # . # # . # # . # # . # # . # # . # # . # # . # # . # # . # # . # # . # # . # # . # # . # # . # # . # # . # # . # # . # # . # # . # # . # # . # # . # # . # # . # # . # # . # # . # # . # # . # # . # # ."